111111111111111111111111111111
11P000OO1OOO1O1OO11OO1O1O11111
1100C0O1111111OO1111O1OOO11111
111100O1O111OO11O1OO1O1O11OOO1
11OOC00011OO11O1O1OO1O11O11O11
1O1100O01O1O1O1O111O111111OO11
11OO10100OOO1OOO1O1O111O11OO11
1OO1O00001O1O111111111O11OOO11
11O10000OO11OOOO11OO1OOOOOOOO1
111O0000O1OO11O1OO1O1O111O1O11
1OO1OO0000000OO1OOO11111111OO1
1O1OO1001O100OOOO11OO111O1OOO1
1OOOO1O0O1O0000OOO111OO111O1O1
111O11O00OO1000O1OOOOOO11O1111
111OOOO1000O0O1111O1O1O1OOOOO1
1O11OO1OO10O011O1O1O11OOOO11O1
11OOOOOOOO00000O11O11OOOOO1OO1
11OOO1OOO1O00O0001OO1OO11O1111
1O1111OO0000011100O11111OO1111
1O11OO100O1O1O0000111OO1111O11
1OOOOOO00011O10OO11O1O11111O11
1OO1O00000OOO00O1OO1OOOO111111
111O1000OOO1O00111OO11O1OO1111
11OOO1O000O1O10OO1O111OOO1OOO1
1O1O1O1OO0O1O00O1OOOOOO1O1OOO1
1OO1O11O00OO1000O1O1OO1OO1O1O1
1O111OOO0000O11011OOOO11OOO111
11OO1O1O1O00111001OO11OO1OOO11
11000000000OOO1100000000000001
111111111111111111111111111111